35 34
6 3
0 0 0 0 0 0 0 0 0 0 0 0 0 0 0 0 0 0 0 0 0 0 0 0 0 0 0 0 0 0 0 0 0 0 0
0 0 4 2 2 2 2 2 10 2 2 2 2 2 2 2 2 2 2 2 3 0 0 0 0 0 0 0 0 0 0 0 0 0 0
0 0 4 1 1 1 1 1 9 1 1 1 1 1 1 1 1 1 1 1 3 0 0 0 0 0 0 0 0 0 0 0 0 0 0
0 0 4 1 10 1 1 1 9 1 1 1 1 1 1 1 1 1 1 1 3 0 4 2 2 2 3 0 0 0 0 0 0 0 0
0 0 4 1 9 1 1 1 9 1 1 1 1 1 1 1 1 1 1 1 3 0 4 1 1 1 3 0 0 0 0 0 0 0 0
0 0 4 1 9 2 2 2 9 1 1 1 1 1 1 1 1 1 1 1 3 0 4 1 1 1 3 0 0 0 0 0 0 0 0
0 0 4 1 9 1 1 1 9 1 1 1 1 1 1 1 1 1 1 1 3 0 4 1 1 1 3 0 0 0 0 0 0 0 0
0 0 4 1 9 2 2 1 9 1 1 1 1 1 1 1 1 1 1 1 2 2 9 1 1 1 9 2 2 2 2 2 3 0 0
0 0 4 1 9 1 1 1 9 1 1 1 1 1 1 1 1 1 1 1 1 1 9 1 1 1 9 1 1 1 1 1 3 0 0
0 0 4 1 9 1 2 2 2 1 13 2 10 2 2 2 2 2 2 1 10 1 9 1 7 11 8 1 13 2 12 1 3 0 0
0 0 4 1 9 1 1 1 1 1 9 1 9 1 1 1 1 1 1 1 9 1 9 1 3 0 4 1 9 1 9 1 3 0 0
0 0 4 1 9 1 1 1 1 1 9 1 9 1 7 11 11 11 11 11 8 1 9 1 2 2 2 1 2 1 9 1 3 0 0
0 0 4 1 9 1 1 1 1 1 9 1 9 1 3 0 0 0 0 0 4 1 9 1 1 1 1 1 1 1 9 1 3 0 0
0 0 4 1 9 1 1 1 1 1 9 1 9 1 3 0 0 0 0 0 4 1 9 1 7 11 8 2 2 2 2 1 3 0 0
0 0 4 1 9 1 1 1 1 1 9 1 9 1 3 0 0 0 0 0 4 1 9 1 3 0 4 1 1 1 1 1 3 0 0
0 0 4 1 9 1 1 1 1 1 9 1 9 1 9 2 2 2 2 2 2 1 9 1 3 0 4 1 13 2 12 1 3 0 0
0 0 4 1 9 1 1 1 1 1 9 1 9 1 9 1 1 1 1 1 1 1 9 1 3 0 4 1 9 1 9 1 3 0 0
0 0 4 1 9 2 2 1 2 2 2 1 9 1 9 1 13 2 2 2 10 2 2 2 2 2 2 1 9 1 9 1 3 0 0
0 0 4 1 9 1 1 1 1 1 1 1 9 1 9 1 9 1 1 1 9 1 1 1 1 1 1 1 9 1 9 1 3 0 0
0 0 4 1 2 2 2 2 2 2 2 2 2 1 9 1 2 2 2 1 9 1 1 1 1 1 1 1 9 1 9 1 3 0 0
0 0 4 1 1 1 1 1 1 1 1 1 1 1 9 1 1 1 1 1 9 1 1 1 1 1 1 1 9 1 9 1 3 0 0
0 0 4 2 2 2 10 2 2 2 2 2 2 2 2 2 2 2 2 1 9 1 1 1 1 1 1 1 9 1 9 1 3 0 0
0 0 4 1 1 1 9 1 1 1 1 1 1 1 1 1 1 1 1 1 9 1 1 1 1 1 1 1 9 1 9 1 3 0 0
0 0 4 1 2 2 2 1 1 1 1 1 1 1 1 1 1 1 7 11 11 11 8 2 2 2 2 1 9 1 9 1 3 0 0
0 0 4 1 1 1 1 1 1 1 1 1 1 1 1 1 1 1 3 0 0 0 4 1 1 1 1 1 9 1 9 1 3 0 0
0 0 4 1 7 11 8 1 1 1 1 1 1 1 1 1 1 1 9 2 2 2 2 2 2 2 2 1 9 1 2 1 3 0 0
0 0 4 1 3 0 4 1 1 1 1 1 1 1 1 1 1 1 9 1 1 1 1 1 1 1 1 1 9 1 1 1 3 0 0
0 0 4 1 2 2 9 1 1 1 1 1 1 1 1 1 1 1 9 1 7 11 11 11 11 11 11 11 8 1 2 2 3 0 0
0 0 4 1 1 1 9 1 1 1 1 1 1 1 1 1 1 1 9 1 3 0 0 0 0 0 0 0 4 1 1 1 3 0 0
0 0 6 11 8 1 2 2 2 2 2 2 2 2 2 2 2 2 2 1 3 0 0 0 0 0 0 0 6 11 11 11 5 0 0
0 0 0 0 4 1 1 1 1 1 1 1 1 1 1 1 1 1 1 1 3 0 0 0 0 0 0 0 0 0 0 0 0 0 0
0 0 0 0 6 11 11 11 11 11 11 11 11 11 11 11 11 11 11 11 5 0 0 0 0 0 0 0 0 0 0 0 0 0 0
0 0 0 0 0 0 0 0 0 0 0 0 0 0 0 0 0 0 0 0 0 0 0 0 0 0 0 0 0 0 0 0 0 0 0
0 0 0 0 0 0 0 0 0 0 0 0 0 0 0 0 0 0 0 0 0 0 0 0 0 0 0 0 0 0 0 0 0 0 0